[TILES]
NO tests/textures/bricks.xpm
SO tests/textures/bricks.xpm
WE tests/textures/bricks.xpm
EA tests/textures/bricks.xpm

F tests/textures/bricks.xpm
C tests/textures/bricks.xpm

[MAP]
1111111111111111111111111111111111111111
1000000000000000000000000000000000000001
1000000000000000000000000000000000000001
1000000000000000000000000000000000000001
1000000000000000000000000000000000000001
1000000000000000001010000000000000000001
1000000000000000001010000000000000000001
1000000000000000001N10010000000000000001
1000000000000000001110010000000000000001
1000000000000000000000000000000000000001
1000000000000000000000000000000000000001
1000000000000000000000000000000000000001
1000000000000000000000000000000000000001
1000000000000000000000000000000000000001
1111111111111111111111111111111111111111

[DECORATIONS]
LIGHT	20.5	3.5	7	2	125,125
